#JSGF V1.0;
grammar sentence;
 
public <sentence> =
[<noun>]
[<adjective>]
[<verb>]
[<number>]
;

<number> = 1 | 2 | 3 | 4 | 5 | 6 | 7 | 8 | 9 | 0;

<noun> = crema | café | estrella |explosión | guitarra | plástico |navaja | martillo | libros |lápiz | lapicera | aluminio |
embarcación | letra | agujeta |ventana | librería | sonido |universidad | rueda | perro |llaves | camisa | pelo |
papá | sillón | felicidad |catre | teclado | servilleta |escuela | pantalla | sol |codo | tenedor | estadística |
mapa | agua | mensaje |lima | cohete | rey |edificio | césped | presidencia |hojas | parlante | colegio |granizo | pestaña | lámpara |
mano | monitor | flor |música | hombre | tornillo |habitación | velero | abuela |abuelo | palo | satélite |templo | lentes | bolígrafo |
plato | nube | gobierno |botella | castillo | enano |casa | libro | persona |planeta | televisor | guantes |metal | teléfono | proyector |
mono | remera | muela |petróleo | percha | remate |debate | anillo | cuaderno |ruido | pared | taladro |herramienta | cartas | chocolate |
anteojos | impresora | caramelos |living | luces | angustia |zapato | bomba | lluvia |ojo | corbata | periódico |diente | planta | chupetín |
buzo | oficina | persiana |puerta | tío | silla |ensalada | pradera | zoológico |candidato | deporte | recipiente |diarios | fotografía | ave |
hierro | refugio | pantalón |barco | carne | nieve |tecla | humedad | pistola |departamento | celular | tristeza |
hipopótamo | sofá | cama |árbol | mesada | campera |discurso | auto | cinturón |rúcula | famoso | madera |
lentejas | piso | maletín |reloj | diputado | cuchillo |desodorante | candado | luz |montañas | computadora | radio |moño | cuadro | calor |
partido | teatro | bife |fiesta | bala | auriculares | fin ;

<adjective> = afortunado | diligente | negro |alto | directo | anaranjado |anormal | dos | nueve |amable | duro | obsecuente |
antiguo | el | ocho |amarillo | enorme | paciente |angosto | estupendo | pequeño |aquel | extremo | popular |
argentino | fácil | primer |azul | famoso | querido |bajísimo | flexible | quinto |bajo | generosos | redonda |blanco | grande | rígido |
blando | gris | rojo |brillante | honesto | segundo |bruto | incómodas | seis |buena | increíble | sencillo |
bueno | indirecto | séptimo |chileno | inepto | sexto |cinco | inexpresiva | siete |complejo | infeliz | simple |
complicado | inobjetable | sincero |conocido | inoperante | soberbio |cualquier | insatisfecho | tercero |cuarto | inteligente | tres |
quinto | la | tu |sexto | las | una |desafortunado | los | uno |desconocido | magnífico | uruguayo |
deshonesto | mala | verde |deteriorado | malo | violeta |diez | marginado | voluptuoso |difícil | mayor | vuestro ;

<verb> = ;

